10,10,,,,,,,,
0,0,2,3,6,6,6,1,1,1
0,3,5,5,7,6,6,0,1,1
3,2,5,0,6,6,6,0,0,1
0,2,5,3,3,0,0,2,0,0
3,0,5,5,0,2,3,0,0,1
3,3,0,5,2,0,0,0,0,0
0,2,2,5,5,2,4,2,0,0
0,0,0,0,5,5,2,1,1,0
3,0,0,0,0,5,2,1,1,0
0,0,2,0,2,5,0,2,1,1
