12,10,,,,,,,,
3,0,2,3,2,3,3,1,1,1
0,3,2,0,2,3,2,0,1,1
3,2,2,0,2,3,2,0,0,1
0,5,5,5,3,0,0,2,0,0
3,5,2,5,0,2,5,5,5,1
5,5,0,5,2,0,5,0,5,0
5,2,2,5,5,5,5,2,5,0
5,0,0,2,0,3,2,1,5,0
5,2,0,2,0,3,2,1,5,0
5,3,2,0,2,2,0,6,7,6
5,2,3,3,0,3,2,6,6,6
5,0,2,0,2,2,0,6,6,6
