8,8,,,,,,,
0,6,6,6,3,2,0,1,1
2,6,6,6,2,2,0,1,1
3,6,7,6,0,3,2,0,1
0,2,5,5,3,2,0,2,1
3,2,3,5,3,2,3,0,2
3,3,2,5,2,2,0,0,3
3,2,2,5,2,2,4,2,0
3,0,0,5,3,5,2,1,1
3,0,0,5,0,5,2,1,1
0,0,2,5,2,5,0,2,1
