8,8,,,,,,
0,6,6,6,3,2,0,1
2,6,6,6,2,2,0,1
3,6,7,6,0,3,2,0
0,0,5,5,0,2,0,2
3,2,0,5,3,2,3,0
3,3,0,5,0,2,0,0
3,2,2,5,0,2,4,2
3,0,0,5,2,3,2,1
