row,10,col,10,,,,,,,,
tiles,0,0,2,0,2,2,0,1,1,1,1
,0,3,2,0,2,2,0,0,1,1,1
,0,0,0,0,0,3,2,0,0,1,1
,0,2,2,0,0,0,0,2,0,0,1
,0,0,0,0,0,2,3,0,0,1,1
,0,3,0,0,2,0,0,0,0,0,1
,0,2,2,0,2,3,4,2,0,0,1
,0,0,0,0,5,2,5,1,1,0,1
,0,0,6,0,0,5,0,1,1,0,1
,0,0,2,0,2,2,0,2,1,1,1
