9,9,,,,,,,,
6,6,6,3,3,2,0,1,1,1
6,6,7,5,2,2,0,0,1,1
6,6,6,5,0,3,2,0,0,1
0,2,3,5,3,0,0,2,0,0
3,0,0,5,0,2,3,0,0,1
3,3,0,5,2,0,0,0,0,0
0,2,2,5,5,2,4,2,0,0
0,0,0,0,5,5,2,1,1,0
3,0,0,0,0,5,2,1,1,0
0,0,2,0,2,5,0,2,1,1
