14,8,,,,,,
0,5,5,5,5,5,3,1
3,5,2,0,2,5,2,0
2,5,2,0,2,5,2,0
2,5,5,5,3,5,0,2
3,3,2,5,0,5,2,2
3,2,0,5,2,5,3,3
2,2,2,5,0,5,2,2
0,5,5,5,6,7,6,0
2,5,0,2,6,6,6,0
3,5,2,0,6,6,6,2
2,5,3,3,0,3,2,3
0,5,2,0,2,2,0,2
3,5,0,2,0,2,2,3
2,5,2,3,3,3,3,2
