6,16,,,,,,,,,,,,,,
3,0,2,3,2,3,3,1,1,1,3,2,3,2,3,2
0,3,2,0,2,3,2,0,1,1,0,2,6,6,6,2
3,2,2,0,2,3,2,0,0,1,5,5,7,6,6,1
0,5,5,5,5,5,5,2,0,0,5,3,6,6,6,1
3,5,2,0,0,2,5,5,5,5,5,0,2,1,1,0
0,5,0,3,2,0,2,0,2,0,3,2,3,1,1,2
